############
#	  O#
#    P  ####
#          #
#######    #
# O  ##    #
#    ##    #
#          #
#      XX  #
#       #  #
############
