#################
#               #
#   X           #
#               #
#       O       #
#               #
#      ###      #
#      O        #
#               #
#  O   P  O     #
#               #
#    X O        #
#           X   #
#  P  O         #
#################




############
#          #
#   X   X  #
#   P      #
#       ####
#          #
#######    #
# O O##    #
#    ##    #
#          #
#      XX  #
#       #  #
############
