############
#          #
#   X   X  #
#   P      #
#       ####
#          #
#######    #
# O  ##    #
#    ##    #
#          #
#      XX  #
#       #  #
############
