####################
#               XO #
####               #
#       O          #
# OX    X          #
#     XO P         #
####################
